20 20
xxxxxxxxxxxxxxxxxxxx
x000xxxxx0010000000x
x00000000xx0000x0x0x
xx00x0x000xx0001001x
x00x0xx100000xxx0x0x
x01x00000x0x0x0x000x
x00000x00x100x100x0x
x00x0xx0000xxxx1010x
x01x1x000001x000xxxx
x00xxx0000000100000x
x010xx0000000x0x0xxx
x00001x0xx00x00x000x
x01000x00x10xx0x00xx
x0000x00x1x0xx00000x
xx0x0x1x001xx00x0x1x
xx00x00100xx0001xx0x
xxx0001000x0000000xx
x010xxx00000xx00000x
x0x0x0xx00000x00000x
xxxxxxxxxxxxxxxxxxxx
