20 20
xxxxxxxxxxxxxxxxxxxx
x0000x000100x0001x0x
xx0000xxxx00x0x0000x
xxx00x00000xx010xx0x
xx00010x1x0000x01x0x
x0000000000x00x1000x
x00xx000001x1x0x000x
xx1x00x01000001x0xxx
x01x11x1000xxxx00x1x
x00x0x00xx0100x0001x
x1000x1xx0x0x001x0xx
xx000000x000xx0x0x0x
xxx0xx0000x1x10x100x
x0010x01x1x000xx0x0x
x0x000xx001xx000000x
x0xx0x10010000x0x11x
x000xx00x100x0x0000x
xxx101xx00100000001x
x000x10100xxx000x00x
xxxxxxxxxxxxxxxxxxxx
