20 20
xxxxxxxxxxxxxxxxxxxx
x0x00x1000xxx001000x
x00000000xx00x00010x
xx0010010x100xx1xx0x
xx00x00x1100xx00000x
x10x00x010001000xx0x
x00xxxxx00x10110x0xx
x0x0xx00x1101x0xx10x
x010xxx00x0x1010000x
x1000x110xxxx1x11x1x
x0xx0000101011x11xxx
xx0000x1x00xx0xx011x
xx0xx00xx0xx000000xx
x0xx00x0x0x0100000xx
x0xx00001xx100x000xx
x0001xxx000xx1111x0x
x00x011x0xxx0x1x000x
xx1xx10000000100001x
x00110xx0xx00x00x00x
xxxxxxxxxxxxxxxxxxxx
